
_3_letter_ISO639_3_code_____Ethnologue_name_of_language_=3-letter ISO639-3 code, Ethnologue name of language
_3_letter_ISO639_3_code_____Language_subject_of_your_research_=3-letter ISO639-3 code, Language subject of your research
A=Adornment
Accuracy=Accuracy
Add_Agent_Role=Add Agent Role
Agent_Role=Agent Role
Alert=Alert
All=All
A_next_ID_has_not_been_entered_please_provide_one=ID has not been entered. Please provide one.
Annotator=Annotator
Any_unsaved_changes_will_be_lost=Any unsaved changes will be lost!
Artifact_Number=Attached Audio
Attached_Video=Attached Video
Attach_Photograph=Attach Photo
Attach_Sketch=Attach Sketch
AU___Australia=Australia
Author=Author
Base=Base
BaseBody=Base and Body
BaseDiameter=Base Diameter
BasePercentage=Base Percentage
BaseThickness=Base Thickness
B=Base
Body=Body
BodyThickness=Body Thickness
Burgos__Ilocos_Sur__Philippines=Burgos, Ilocos Sur, Philippines
Button_Attached_Audio=Attach Audio
Button_Attached_Video=Attach Video
C=Carination
Clean_Synced_Files=Clean Synced Files
CO=Carination with Body
Compiler=Compiler
Confirm_Deletion=Confirm Deletion
Conjunto=Conjunto
Control=Control
Country=Country
Data_Inputter=Data Inputter
DB=Shoulder to Base
D=Shoulder
Delete_Cancelled=Delete Cancelled
Delete=Delete
Depositor=Depositor
Description=Description
Developer=Developer
Dialogue=Dialogue
Disable_External_GPS=Disable External GPS
Disable_Internal_GPS=Disable Internal GPS
Disable_Sync=Disable Sync
Discourse_Type=Discourse Type
Drama=Drama
Duplicated_record=Duplicated Record
Duplicate=Duplicate
Easting=Easting
Editor=Editor
E=Leg or Foot
Enable_External_GPS=Enable External GPS
Enable_Internal_GPS=Enable Internal GPS
Enable_Sync=Enable Sync
eng___English=English
Entity_List=Entity List
Entity_Types=Entity Types
External_GPS_Disabled=External GPS Disabled
External_GPS_Enabled=External GPS Enabled
False=False
F=Figurine
Firing=Firing
First_Name=First Name
Formulaic=Formulaic
Functional_Category_2=Functional Category 2
Functional_Category=Functional Category
General_Form_Category=General Form Category
General_WARE_Category=General Ware Category
GPS_Diagnostics=GPS Diagnostics
GPS_is_no_longer_initialised=GPS is No Longer Initialized
GPS_is_not_initialised=GPS is Not Initialized
GPS_Not_Initialised=GPS Not Initialized
HandleForm=Handle Form
Handle=Handle
HandleHeight=Handle Height
HandleLength=Handle Length
HandleThickness=Handle Thickness
HandleWidth=Handle Width
H=Handle
Historical_Linguistics=Historical Linguistics
Ilocano=Ilocano
ilo___Ilocano=Ilocano
Internal_GPS_Disabled=Internal GPS Disabled
Internal_GPS_Enabled=Internal GPS Enabled
Internal_GPS=Internal GPS
Interpreter=Interpreter
Interviewer=Interviewer
Interview=Interview
Inventory_Number=Inventory Number
Language_Content_ISO639-3=Language Content ISO639-3
Language_Description=Language Description
Language_Documentation=Language Documentation
Language_Local_Name=Language Local Name
Language___local_spelling__free_text_=Local Spelling of Language
Language_Subject_ISO639-3=Language Subject ISO639-3
Last_Name=Last Name
Latitude=Latitude
Lexicography=Lexicography
Lexicon=Lexicon
Linguistic_Data_Type=Linguistic Data Type
Linguistic_Subject=Linguistic Subject
List_of_Agent_Roles=List of Agent Roles
L=Lug
_locality____state_or_province____country_=Locality, State or Province, Country
Locus=Locus
Login=Login
Longitude=Longitude
Ludic=Ludic
M1=Whistle from Whistling Vessel
Main=Main
mis___Uncoded_languages=Uncoded languages
mul___Multiple_languages=Multiple languages
Narrative=Narrative
NeckHeight=Neck Height
Neck=Neck
NeckThickness=Neck Thickness
New=New
New_record_created=New Record Created
N=Neck Section
no_GPS_position_could_be_found=No GPS position could be found
Northing=Northing
Notes=Notes
OB=Base and Body
off=Off
OH=Body and Handle
on_and_bluetooth_connected=On and Bluetooth Connected
on_and_bluetooth_disconnected=On and Bluetooth Disconnected
ON=Shoulder to Neck
O=Body
Oratory=Oratory
Origination_Date_Narrative=Origination Date Narrative
Origination_Date=Origination Date
P1=Matrix
P2=Mold
P4=Kiln Waster or Misfired
Participant=Participant
Paste_Code=Paste Code
Performer=Performer
Period=Period
Phonology=Phonology
Photographer=Photographer
Photograph=Take Photo
PH___Philippines=Philippines
Please_Enable_Bluetooth=Please Enable Bluetooth
Position=Position
Predominant_Paste_Color=Predominant Paste Color
Press_OK_to_Delete_this_Record=Press OK to Delete This Record
Previous_status=Previous Status
Primary_Text=Primary Text
Private=Private
Procedural=Procedural
Questions=Questions
RB=Rim to Base
Recorder=Recorder
Record_Interview=Record Interview
Region_Villiage=Region Village
Report=Report
Researcher=Researcher
RN=Rim and Neck
Role=Role
R=Rim
RY=Partial Rim (lip only)
Search=Search
Search_Term=Search Term
Select_User=Select User
Sherd_Type=Sherd Type
SH=Spout and Handle
Signer=Signer
Singer=Singer
Singing=Singing
Speaker=Speaker
Special_Find_Number=Special Find Number
S=Spout
Style=Style
Surface_Condition=Surface Condition
Sync_Disabled=Sync Disabled
Sync_Enabled=Sync Enabled
T2=Spindle Whorl
Tab1=Main
Tab2=Notes
Tab3=General Ware
Tab4=Firing
Tab5=Surface
Tab6=Attach
Tab8=Decoration Technique
Take_From_GPS=Take From GPS
Text_And_Corpus_Linguistics=Text And Corpus Linguistics
This_record_is_unsaved_and_cannot_be_duplicated=This record is unsaved and cannot be duplicated
Title=Title
Transcriber=Transcriber
Translator=Translator
True=True
Typology=Typology
und___Undetermined_languages=Undetermined Languages
Unintelligible_speech=Unintelligible Speech
Unit=Unit
User=User
Validate=Validate
Warning=Warning
Weight=Weight
W=Whole Ceramic
You_must_save_this_tabgroup_first=You must save this tab group first
zxx___No_linguistic_content=No linguistic content
Z=Unidentified Part
CUP=Cupisnique
MCE=Early Moche
MCM=Middle Moche
MCL=Late Moche
TRS=Transitional
CJC=Cajamarca Costeña
CJK=Cajamarca
LME=Sicán/Early Lambayeque
LMM=Sicán/Middle Lambayeque
LML=Sicán/Late Lambayeque
CHM=Chimú
CHI=Chimú-Inka
INK=Inka (non-local)
COL=Colonial
UNK=Unknown, can’t determine style
FOR=Formative
EIP=Early Intermediate Period
MHO=Middle Horizon
LIP=Late Intermediate Period
LHO=Late Horizon
LPH=LIP or LH, unclear
LHC=Late Horizon or Colonial
COL=Colonial (indeterminate)
ECO=Early Colonial
LCOL=Late Colonial
REP=Republican
MOD=Modern
COO=Cooking vessel
COS=Cooking or storage vessel
PCA=Food processing or Agricultural production
PCU=Ceramic or Metallurgical production
SER=Serving vessel
STO=Storage vessel
SFU=Special Function
TRN=Transport
NOB=Not observable
BBW=Slipped Brownware
BOT=Olive Jar
DKK=Slipped Blackware
LOZ=High fire ware, usually kaolin
OTH=Other
PAL=Paddle-stamped decorations
PI=Provincial Inka polychrome
PLN=Plain, Unglazed Earthenware without slip, decoration, or paddle-stamped marks
PRC=Porcelain
PRW=Panamanian redware
STN=Stoneware
VID-GYG=Early Green Glazed Ware
VID-PANP=Panamanian Plain majolica
VID-PANBW=Panamanian Blue-on-white majolica
VID-PANPLA=Panamanian Polychrome Type A Majolica
VID-SBB=Seville Blue on Blue
VID-SNO=Undetermined tin-glazed earthenware
VID-OTH=Other unidentified glazed ware
WCW=White Slipped Earthenware
BLB=Vessel with a “brim” or platform, vertiginous sides, possible ebrillo
CBC=Cumbrous bowl, slight constriction at rim
CBR=Cumbrous bowl, rim at near max width
LOB=Large bowl, open
LBL=Large bowl, vertical sides
OSM=Small bowl, open, which could have been grasped in the hand
POB=Plate or bowl, unclear
ROB=Rounded open bowl
SBO=Large straight sided bowl, slightly open
SBR=Straight-sided bowl, max diameter near rim (may be large taza, like LCP, but with thicker rim) 
SOA=Shallow open bowl, planar base with angle
SOB=Slightly open bowl
SRB=Shallow rounded bowl
SSB=Straight-sided bowl, open
BPL=Brimmed Plate
LPO=Large open plate 
PLM=Plate-medium, slightly open (no better classification possible)
PNI=Unidentifiable plate
PPL=Potter's plate
PPP=Planar plate (very open)
RPO=Rounded plate (open)
SRP=Small rounded plate (open)
ARS=Aribayllo form, small
CNC=Cántaro with convex neck
CNE=Cántaro with everted neck
CNR=Cántaro with straight neck
CNX=Cántaro with expanded rim
HBL=Handle: Mid-body join, as in pitcher, large
HBS=Handle: Mid-body join, as in pitcher, small
TRR=Other Reinforced rim Tinaja
TSR=Other Simple-rimmed Tinaja
TTE=Early Style Olive Jar
TTL=Late Style Olive Jar
TTM=Middle Style Olive Jar
TTU=Undetermined Age Olive Jar
BLC=Compound bottle with lateral handle (more than one body)
BLS=Simple bottle with lateral handle
BNI=Unidentifable bottle form
BSC=Compound Stirrup Spout Bottle (more than one body)
BSS=Simple Stirrup Spout Bottle
FLO=“Flower vase”
KER=K'ero
LCO=Large cup slighly open
LCP=Large cup (slightly closed)
SCO=Small cup slightly open
SCP=Small cup (slightly closed)
RJ=Handle: rim join, as in olla
MTG=Toasting griddle or plate
OCC=Carenated neck bowl
OER=Neckless pot with everted lip
OFR=Olla with flaring rim
ONI=Unidentifiable pot
OPN=Pot with Platform neck
OSC=Neckless pot with inverted Neck
OSR=Olla with straight rim
ALS=Polisher
AP=Perforated Adornment
AZL=Floor or Wall Tile
CIR=Modified sherd, ground into circular form
CLB=Candle Holder
CRS=Crucible
FGN=Figurine
HMS=Handle strap mid section only
IMU=Musical instrument
MLD=Mold
RAY=Grater
TEJ=Roof tile
TIN=Ink well
UKN=Unknown-sherd small or body only
WOR=Slightly worked (smoothed) sherd, ground slightly along edge
CE=Complete core but less oxidized exterior
CI=Complete core but less oxidized interior
CN=Complete but not oxidized red; buff to brown throughout
CO=Complete and oxidized throughout, red 
CR=Completely reduced
CS=Completely oxidized, except for thin reduced layer on exterior
CX=Complete core but with less oxidized exterior and interior layers
IA=Incomplete firing; dark reduced core
IE=Incomplete firing; exfoliating outer layer or slip 
IG=Incomplete firing with "ghost" of reduced core
IK=Incomplete Exterior oxidized red; interior buff to light brown
IL=Incomplete; Interior oxidized red; exterior buff to light brown 
IM=Incomplete firing; interior buff to light brown, exterior reduced 
IN=Incomplete firing; interior reduced, exterior buff to light brown 
IO=Incomplete firing; interior reduced, exterior oxidized red 
IP=Incomplete firing, with poor firing throughout, low temp and brittle, brownish 
IR=Incpmplete; interior reduced, exterior buff, brown 
IT=Incomplete, v. dark throughout, except outermost layer and slip 
IU=Incomplete; reduced, except for outermost AND innermost layers
IX=Incomplete; interior and exterior reduced; buff to light brown core
IY=Incomplete; exterior reduced, interior oxidized
IZ=Incomplete; interior and exterior oxidized red; buff to light brown core
VI=Vitrified, as in porcelain
BB=Battering on interior AND exterior
BN=Battering on interior 
CC=Calcium Carbonate Interior and Exterior
CN=Calcium Carbonate Interior; nothing exterior
CS=Calcium Carbonate Interior and soot exterior
EE=Heavily Eroded Overall
EN=Interior Eroded 
GN=Slag in Interior
NB=Battering on exterior
NC=Calcium Carbonate Exterior
NE=Exterior Eroded
NN=None
SN=Soot Interior
NS=Soot Exterior
SS=Soot Interior and Exterior
VN=Vitrified material Exterior
WW=Minimal Weathering
BLB=Buff to light brown 
BLK=Black
BRD=Bright red 
BRN=Brown
CDP=Carbon deposited during firing, obscuring original color
CRM=White or cream, unglazed
DRD=Dark red 
EXF=Exfoliated
ORG=Orange
AP=Apliqué
ES=Mechanical Stamping
EX=Excising
FP=Finger-pinching
GR=Grooving
IM=Impressing
IN=Incising
MD=Modeling
MO=Molding
OP=Openwork (champlevé)
PA=Painting
PC=Runny Paint
PS=Paddle Stamping
PU=Punctation
SS=Shell Stamping
VID=Glazed
ZO=Zoning
New_Bag=New Bag
Same_Bag=Same Bag
EntityTypes=Entity Types
Select_Area_Code=Select Area Code
EntityList=Entity List
Contexts=Contexts
LoadTabs=Load Tabs
firing=Firing
firi=Firing
fir=Firing
BodyThicknessOPT=Body Thickness
BODYOPT=Body
Rim=Rim
RimProfile=Rim Profile
RimDiameter=Rim Diameter
RimThickness=Rim Thickness
RimPercent=Percent of Rim Present
SPOUT=Spout
SpoutDiameter=Spout Diameter
BaseThicknessOPT=Base Thickness
BaseDiameterOPT=Base Diameter
BasePercentMAN=Percentage of Base Present
BodyDiamOPT=Body Diameter
HandleFormOPT=Handle Form
HandleWidthOPT=Handle Width
HandleThicknessOPT=Handle Thickness
HandleLengthOPT=Handle Length
HandleHeightOPT=Handle Height
Date=Date
Whole=Whole
Details=Fill out Artifact Details
Bowls=Bowls
Plates=Plates
Jars=Jars
Tinajas_y_Botijas=Tinajas and Botijas
Botellas=Bottles
Cups=Cups
Ollas=Ollas
Other=Other