
_3_letter_ISO639_3_code_____Ethnologue_name_of_language_=[3-letter ISO639-3 code] - [Ethnologue nombre de la idioma]
_3_letter_ISO639_3_code_____Language_subject_of_your_research_=[3-letter ISO639-3 code] - [Idioma tema de su investigación] 
A=Adorno
Accuracy=Exactitud
Add_Agent_Role=Añadir el Papel del Agente
Agent_Role=Papel del Agente
Alert=Atención
All=Todos
A_next_ID_has_not_been_entered_please_provide_one=Identificación no se ha introducido. Por favor proporcione una.
Annotator=Comentador
Any_unsaved_changes_will_be_lost=Los Cambios no Guardados se Perderán
Artifact_Number=Numero de Artefacto
Attached_Audio=Audio Adjunto
Attached_Video=Video Adjunto
Attach_Photograph=Cargar Fotografía
Attach_Sketch=Cargar Dibujo
AU___Australia=AU - Australia
Author=Autor
Base=Base
BaseBody=Base y Cuerpo
BaseDiameter=Diametro de Base
BasePercentage=Porcentaje de la Base Presente
BaseThickness=Espesor de Base
B=Base
Body=Cuerpo
BodyThickness=Espesor de Cuerpo
Burgos__Ilocos_Sur__Philippines=Burgos, Ilocos Sur, Filipinas
Button_Attached_Audio=Audio Cargado
Button_Attached_Video=Video Cargado
C=Carenado
Clean_Synced_Files=Archivos Sincronizados Limpios
CO=Carenado con Cuerpo o Hombro Conectado
Compiler=Compilador
Confirm_Deletion=Confirmar la Eliminación
Conjunto=Conjunto
Control=Control
Country=País
Data_Inputter=Información Entradador
DB=Hombro a Base
D=Hombro
Delete_Cancelled=Eliminación Cancelado
Delete=Eliminar
Depositor=Depositante
Description=Descripción
Developer=Desarrollador
Dialogue=Diálogo
Disable_External_GPS=Desactivar GPS Externo
Disable_Internal_GPS=Desactivar GPS Interno
Disable_Sync=Desactivar la Sincronización
Discourse_Type=Tipo de Discurso
Drama=Drama
Duplicated_record=Anotación Duplicada
Duplicate=Duplicado
Easting=Easting
Editor=Editor
E=Pierna o Pie
Enable_External_GPS=Activar GPS Externo
Enable_Internal_GPS=Activar GPS Interno
Enable_Sync=Activar la Sincronización
eng___English=Inglés
Entity_List=Lista de Entidades
Entity_Types=Tipos de Entidades
External_GPS_Disabled=GPS Externo Desactivado
External_GPS_Enabled=GPS Externo Activado
False=Falso
F=Figurina
Firing=Cocción
First_Name=Nombre
Formulaic=Predecible
Functional_Category_2=Categoría Funcional 2
Functional_Category=Categoría Funcional
General_Form_Category=Categoría de Forma en General
General_WARE_Category=Categoría General
GPS_Diagnostics=Diagnósticos GPS
GPS_is_no_longer_initialised=GPS ya no se Inicializa
GPS_is_not_initialised=GPS no es Inicializa
GPS_Not_Initialised=GPS no es Inicializa
HandleForm=Forma de Asa
Handle=Asa
HandleHeight=Altura de Asa
HandleLength=Largo de Asa
HandleThickness=Espesor de Asa en Medio
HandleWidth=Anchura de Asa en Medio
H=Asa
Historical_Linguistics=Lingüístico Histórico
Ilocano=Ilocano
ilo___Ilocano=Ilocano
Internal_GPS_Disabled=GPS Interno Desactivado
Internal_GPS_Enabled=GPS Interno Activado
Internal_GPS=GPS Interno
Interpreter=Intérprete
Interviewer=Entrevistador
Interview=Entrevista
Inventory_Number=Numero de Inventario
Language_Content_ISO639-3=Contenido del Idioma ISO639-3
Language_Description=Descripción del Idioma
Language_Documentation=Documentación del Idioma
Language_Local_Name=Nombre Local del Idioma
Language___local_spelling__free_text_=Ortografía Local del Idioma
Language_Subject_ISO639-3=Tema del Idioma ISO639-3
Last_Name=Apellido
Latitude=Latitud
Lexicography=Lexicografía
Lexicon=Lexicón
Linguistic_Data_Type=Tipo de Data Lingüístico
Linguistic_Subject=Tema Lingüístico
List_of_Agent_Roles=Lista de Papeles del Agente
L=Oreja
_locality____state_or_province____country_=Localidad, Estado, País
Locus=Sitio
Login=Ingreso
Longitude=Longitud
Ludic=Lúdico
M1=Silbador de Huaco Silbato
Main=Principal
mis___Uncoded_languages=Idiomas no Codificados
mul___Multiple_languages=Múltiples Idiomas
Narrative=Narración
NeckHeight=Altura de Cuello
Neck=Cuello
NeckThickness=Espesor de Cuello
New=Nuevo
New_record_created=Nuevo Registro Creado
N=Sección de Cuello
no_GPS_position_could_be_found=No posición de GPS se pudo encontrar
Northing=Nada
Notes=Notas
OB=Base con Cuerpo
off=Apagado
OH=Cuerpo y Asa
on_and_bluetooth_connected=Encendido y Bluetooth Conectado
on_and_bluetooth_disconnected=Encendido y Bluetooth Desconectado
ON=Hombro con cuello
O=Cuerpo
Oratory=Oratoria
Origination_Date_Narrative=Fecha Narración Origen
Origination_Date=Fecha Origen
P1=Pasta sin Evidencia de Superficie Interno o Externo
P2=Molde
P4=Desperdicio de Horno o Fallado
Participant=Participante
Paste_Code=Código de Pasta
Performer=Intérprete
Period=Periodo
Phonology=Fonología
Photographer=Fotógrafo
Photograph=Toma una Foto
PH___Philippines=Filipinas
Please_Enable_Bluetooth=Por Favor Activa Bluetooth 
Position=Posición
Predominant_Paste_Color=Color Predominante de Pasta
Press_OK_to_Delete_this_Record=Pulsa "ok" para Eliminar este Anotación
Previous_status=Estado Anterior
Primary_Text=Texto Primario
Private=Privado
Procedural=Procedimental
Questions=Preguntas
RB=Borde a Base
Recorder=Anotandor
Record_Interview=Grabar Entrevista
Region_Villiage=Territorio y Aldea
Report=Relato
Researcher=Investigador
RN=Borde y Cuello
Role=Papel
R=Borde
RY=Borde Parcial (solo labio)
Search=Buscar
Search_Term=Buscar un Término
Select_User=Seleccionar Usuario
Sherd_Type=Tipo de Fragmento
SH=Pico y Asa
Signer=Firmante
Singer=Cantante
Singing=Cantando
Speaker=Locutor
Special_Find_Number=Numero de Hallazgo Especial
S=Pico
Style=Estilo
Surface_Condition=Condición de Superficie
Sync_Disabled=Sincronización Desactivado
Sync_Enabled=Sincronización Activado
T2=Piruru
Tab1=Principal
Tab2=Notas
Tab3=Categoría General
Tab4=Cocción
Tab5=Superficie
Tab6=Cargar
Tab8=Técnica de decoración
Take_From_GPS=Recuperar del GPS
Text_And_Corpus_Linguistics=Texto y Corpus Lingüístico
This_record_is_unsaved_and_cannot_be_duplicated=Este Anotación no es Guardado y no Puede Ser Duplicado
Title=Titulo
Transcriber=Transcriptor
Translator=Traductor
True=Cierto
Typology=Tipología
und___Undetermined_languages=Idiomas Indeterminados
Unintelligible_speech=Pronunciación Ininteligible
Unit=Unidad
User=Usuario
Validate=Validar
Warning=Aviso
Weight=Peso
W=Cerámica Completa
You_must_save_this_tabgroup_first=Tiene que guarder primero estas pestañas 
zxx___No_linguistic_content=No Contenido Lingüístico
Z=Parte no Identificado
MCE=Moche Temprano
MCM=Moche Medio
MCL=Moche Tardío
TRS=Transitional
CJC=Cajamarca Costeña
CJK=Cajamarca
LME=Sicán/Lambayeque Temprano
LMM=Sicán/Lambayeque Medio
LML=Sicán/Lambayeque Tardío
CHM=Chimú
CHI=Chimú-Inka
INK=Inka (no local)
COL=Colonial
UNK=Desconocido, no se puede determinar el estilo
FOR=Formativo
EIP=Intermedio Temprano
MHO=Horizonte Medio
LIP=Intermedio Tardío
LHO=Horizonte Tardío
LPH=LIP o  LH (indeterminado)
LHC=Horizonte Tardío o Colonial (indeterminado)
COL=Colonial (indeterminado)
ECO=Colonial Temprano
LCOL=Colonial Tardío
REP=Republicano
MOD=Moderno
COO=Vasija de cocinar
COS=Vasija de cocinar o de almacenaje
PCA=Procesar alimentos o productos agricolas
PCU=Metalurgia o Producción de Cerámica
SER=Vasija de presentación
STO=Vasija de almacenaje
SFU=Función especial
TRN=Transporte
NOB=No observable
BBW=Engobe color cafe
BOT=Botija colonial
DKK=Engobe Negro o Marrón Oscuro
LOZ=Loza, cocida a temperaturas altas (PASTA VIDRIADA)
OTH=Otro
PAL=Decoraciones palateadas
PI=Polícoromo Inka Provincial
PLN=Llana; utilitario sin engobe, decoración o palateada
PRC=Porcelana
PRW=Redware Panameño
STN=Gres
VID-GYG=Tipo vidriado verde-amarillo
VID-PANP=Majolica Panameña Llana
VID-PANBW=Majolica Panameña tipo azul sobre blanco
VID-PANPLA=Majolica Panameña policromo A
VID-SBB=Sevilla Azul sobre Azul
VID-SNO=Majolica no-identificada
VID-OTH=Vidriado no identificado
WCW=Ceramica marron, café, o anaranjado con engobe o pintura blanca (NOT BOTIJA)
BLB=Vasija con “brim” o plataforma, lados vertiginosos, posible ebrillo
CBC=Cuenco, un poco mas constreñido en borde
CBR=Cuenco, borde cerca a anchura maxima
LOB=Escudilla grande, abierta
LBL=Escudilla grande, lados verticales
OSM=Bol pequeño, abierto, que se habría podido agarrar en la mano
POB=Plato o escudilla (indeterminado)
ROB=Escudilla abierta, redonda
SBO=Escudilla, lados rectos, grande, poco abierto
SBR=Escudilla con lados rectos y diametro maximo cerca al borde (puede ser taza grande, como LCP, pero con borde mas grueso)
SOA=Escudilla poco profundo, base horizontal con angulo
SOB=Escudilla un poco abierto (entre escudilla y cuenco)
SRB=Escudilla poco profunda, redonda
SSB=Escudilla abierta con lados rectos
BPL=Brimmed Plato (colonial)
LPO=Plato abierto grande (fuente?)
PLM=Tamaño medio, boca poco abierto (no hay major classificación)
PNI=Plato no identificado
PPL=Plato de alfarero
PPP=Plato planar (muy abierto)
RPO=Plato redondeado mediano (abierto)
SRP=Plato redondeado pequeño (abierto)
ARS=Aríbalo pequeño
CNC=Cántaro con cuello convexo
CNE=Cántaro con cuello evertido
CNR=Cántaro con cuello recto
CNX=Cántaro de cuello expandido
HBL=Asa: juntura de medio del cuerpo (parece jarra), mediana
HBS=Asa: juntura en medio del cuerpo (parece jarra), pequeño
TRR=Tinaja de Borde Reforzado
TSR=Tinaja de Borde Simple
TTE=Botija Colonial Estilo Temprano
TTL=Botija Colonial  Estilo Tardío
TTM=Botija  Colonial Estilo Medio
TTU=Botija Colonial de Estilo Indeterminado
BLC=Botella asa lateral compuesta
BLS=Botella asa lateral simple
BNI=Botella no identificado
BSC=Botella asa estribo compuesta
BSS=Botella asa estribo simple
FLO=Florero
KER=K'ero
LCO=Vaso pequeño, un poco abierto
LCP=Vaso grande, un poco cerrado
SCO=Vaso pequeño un poco abierto
SCP=Vaso pequeño un poco cerrado
RJ=Juntura de Asa y Borde de Olla
MTG=Canchero
OCC=Olla con cuello carenado
OER=Olla sin cuello con labio evertido
OFR=Olla grande con cuello convexo
ONI=Olla no identificada
OPN=Olla con cuello plataforma
OSC=Olla sin cuello invertido
OSR=Olla de cuello recto
ALS=Alisador
AP=Aplicación Perforado
AZL=Azulejo
CIR=Fragmento modificado para hacer un círculo
CLB=Candelabro
CRS=Crisol
FGN=Figurina
HMS=Solamente sección medio de una asa
IMU=Instrumento Musical
MLD=Molde
RAY=Rayador
TEJ=Teja
TIN=Tintero
UKN=No se puede determinar
WOR=Fragmento un poco trabajado, molido un poco al borde
CE=Completamente oxidado pero exterior menos oxidado
CI=Completamente oxidado pero interior menos oxidado
CN=Centro completo pero no un rojo oxidado, marron claro a marrón
CO=No hay centro; oxidado rojo completo
CR=Completo, reducido en todas partes
CS=Oxidado en todas partes, sino exterior, donde hay capa fina reducida
CX=Centro completo pero con superficies exteriores y interiores menos oxidados
IA=Coccion o calentamiento incompleto con centro obscuro y reducido
IE=Coccion o calentamiento incompleto con la capa o engobe externa exfoliada
IG=Coccion o calentamiento con un fantasma del centro reducido
IK=Exterior Oxidado rojo interior marroncillo
IL=Interior oxidado rojo; exterior marroncillo
IM=Interior marrón claro a café claro; exterior reducido
IN=Interior reducido, exterior marrón claro a café claro
IO=Interior reducido; exterior rojo oxidado
IP=Coccion o calentamiento incompleto, mal cocido, temperatura baja y quebradizo, marroncillo 
IR=Interior reducido, exterior marroncillo
IT=Muy oscuro en todas partes con la excepción de parte externa
IU=Reducido en todas partes, menos partes más interiores Y exteriores
IX=Interior marrón claro a oscuro; exterior reducido
IY=Exterior reducido interior rojo oxidado
IZ=Centro marrón claro a café claro; interior y exterior oxidado, rojo
VI=Vitrificado, como porcelana
BB=Exterior y interior chancado
BN=Interior Chancado
CC=Carbonato de Calcio interior y exterior
CN=CaCO3 interior; exterior nada
CS=CaCO3 interior; carbon exterior
EE=Desgastado por todo
EN=Erosionado en Interior
GN=Escoria en Interior
NB=Exterior Chancado
NC=Carbonato de Calcio Exterior
NE=Erosionado en exterior
NN=No se nota
SN=Carbón Interior
NS=Carbón Exterior
SS=Carbón Interior y Exterior
VN=“Sobrecocho” en exterior
WW=Desgaste ligero
BLB=Marrón claro a café claro
BLK=Negro
BRD=Rojo brillante
BRN=Café
CDP=Carbón depositado en superficie durante cocción, cubriendo color original
CRM=Blanco o crema (sin vidriado)
DRD=Rojo oscuro
EXF=Exfoliado
ORG=Naranja
AP=Aplicación
ES=Estampado Mechanico (como en loza producido en masa)
EX=Subtracción o excisa
FP=“Pizca” con dedos
GR=Ranuras
IM=Impresión
IN=Incisión
MD=Moldeado
MO=Moldeaje
OP=Calado
PA=Pintura
PC=Pintura Chorreada
PS=Palateado
PU=Punteado
SS=Estampado con conchas
VID=Vidriado
ZO=División en zonas
New_Bag=Nueva Bolsa
Same_Bag=La Misma Bolsa
EntityTypes=Tipo de entidad
Select_Area_Code=Seleccionar Código de Area
EntityList=Lista de entidades
Contexts=Contextos
LoadTabs=Cargar las pestañas
firing=Cocción
firi=Cocción
fir=Cocción
BodyThicknessOPT=Espesor de Cuerpo
BODYOPT=Cuerpo
Rim=Borde
RimProfile=Perfil de Borde
RimDiameter=Diametro de Borde
RimThickness=Espesor de Borde
RimPercent=Porcentaje de Borde Presente
SPOUT=Pico
SpoutDiameter=Diametro de Pico
BaseThicknessOPT=Espesor de Base 
BaseDiameterOPT=Diametro de Base 
BasePercentMAN=Porcentaje de la Base presente 
BodyDiamOPT=Diámetro de Cuerpo
HandleFormOPT=Forma de Asa 
HandleWidthOPT=Anchura de Asa 
HandleThicknessOPT=Espesor de Asa 
HandleLengthOPT=Largo de Asa 
HandleHeightOPT=Altura de Asa 
Date=Fecha
Whole=Entero
Details=Completar los detalles de la cerámica
Bowls=Cuencos
Plates=Platos
Jars=Cántaro
Tinajas_y_Botijas=Tinajas y Botijas
Botellas=Botellas
Cups=Vasos
Ollas=Ollas
Other=Otro